0 1 1 1 1 1 1 1 1 1 1 1 1 1 1 6
7 8 9 10 10 10 10 10 10 10 10 10 10 11 12 13
14 15 16 17 17 17 17 17 17 17 17 17 17 18 19 20
14 15 16 17 17 17 17 17 17 17 17 17 17 18 19 20
14 15 16 17 17 17 17 17 17 17 17 17 17 18 19 20
14 15 16 17 17 17 17 17 17 17 17 17 17 18 19 20
14 15 16 17 17 17 17 17 17 17 17 17 17 18 19 20
14 15 16 17 17 17 17 17 17 17 17 17 17 18 19 20
14 15 16 17 17 17 17 17 17 17 17 17 17 18 19 20
21 22 23 24 24 24 24 24 24 24 24 24 24 25 26 27
28 29 30 31 31 31 31 31 31 31 31 31 31 32 33 34
35 36 36 36 36 36 36 36 36 36 36 36 36 36 36 41