0 1 1 1 1 1 1 1 1 1 1 1 1 1 1 2
3 4 5 6 6 6 6 6 6 6 6 6 6 7 8 9
3 10 11 12 12 12 12 12 12 12 12 12 12 13 14 9
3 10 11 12 12 12 12 12 12 12 12 12 12 13 14 9
3 10 11 12 12 12 12 12 12 12 12 12 12 13 14 9
3 10 11 12 12 12 12 12 12 12 12 12 12 13 14 9
3 10 11 12 12 12 12 12 12 12 12 12 12 13 14 9
3 10 11 12 12 12 12 12 12 12 12 12 12 13 14 9
3 10 11 12 12 12 12 12 12 12 12 12 12 13 14 9
3 10 15 16 16 16 16 16 16 16 16 16 16 17 14 9
3 18 19 19 19 19 19 19 19 19 19 19 19 19 20 9
21 22 22 22 22 22 22 22 22 22 22 22 22 22 22 23