0 0 0 0 0 0 0 0 0 0 0 0 0 0 0 0 0 0 0 0 0 0 0 0 0 0 0 0 0 0 0 0 0 0 0 0 0 0 0 0 0 0 0 0 0 0 0 0 0 0 
0 0 0 0 0 0 0 0 0 0 0 0 0 0 0 0 0 0 0 0 0 0 0 0 0 0 0 0 0 0 0 0 0 0 0 0 0 0 0 0 0 0 0 0 0 0 0 0 0 0 
0 0 0 0 0 0 0 0 0 0 0 0 0 0 0 0 0 0 0 0 0 0 0 0 0 0 0 0 0 0 0 0 0 0 0 0 0 0 0 0 0 0 0 0 0 0 0 0 0 0 
0 0 0 0 0 0 0 0 0 0 0 0 0 0 0 0 0 0 0 0 0 0 0 0 0 0 0 0 0 0 0 0 0 0 0 0 0 0 0 0 0 0 0 0 0 0 0 0 0 0 
0 0 0 0 0 0 0 0 0 0 0 0 0 0 0 0 0 0 0 0 0 0 0 0 0 0 0 0 0 0 0 0 0 0 0 0 0 0 0 0 0 0 0 0 0 0 0 0 0 0 
0 0 0 0 0 0 0 0 0 0 0 0 0 0 0 0 0 0 0 0 0 0 0 0 0 0 0 0 0 0 0 0 0 0 0 0 0 0 0 0 34 0 0 0 0 0 0 0 0 0 
0 0 0 0 0 0 0 0 0 0 0 0 0 0 0 0 0 0 0 0 0 0 0 0 0 0 0 0 0 0 0 0 0 0 0 0 0 0 0 0 0 0 0 0 0 0 0 0 0 0 
0 0 0 0 0 0 0 0 0 0 0 0 0 0 0 0 0 0 0 0 0 0 0 0 0 0 2 3 3 3 3 3 14 0 0 0 0 0 0 0 0 0 0 0 0 0 0 0 0 0 
0 0 0 0 0 0 0 0 0 0 0 2 3 3 3 3 14 0 0 0 0 0 0 0 0 2 28 20 21 22 23 24 25 0 0 0 0 0 0 0 2 3 3 3 3 3 14 0 0 0 
0 0 0 0 0 0 0 0 0 0 0 19 20 21 23 24 27 3 14 0 0 0 0 0 2 28 34 4 5 1 7 8 25 0 0 0 0 2 3 3 3 20 21 22 23 24 25 0 0 0 
0 0 0 0 0 0 0 0 0 0 0 19 4 5 1 31 23 24 27 3 14 0 2 3 28 20 21 32 1 1 7 8 25 0 0 0 0 19 20 21 22 32 1 1 7 8 27 3 14 0 
0 0 0 0 0 0 0 0 2 3 3 28 4 5 1 1 1 31 23 24 27 3 28 20 21 32 1 1 1 1 7 8 25 0 0 2 3 28 4 5 1 1 1 1 1 31 23 24 25 0 
0 0 0 2 3 3 3 3 28 20 21 22 32 1 1 1 1 1 1 31 22 22 22 32 1 1 1 1 1 1 7 8 25 0 0 19 20 21 32 1 1 1 1 1 1 1 7 8 25 0 
0 0 0 19 20 21 22 22 22 32 1 1 1 1 1 1 1 1 1 1 1 1 1 1 1 1 1 1 1 1 7 8 27 3 14 19 4 5 1 1 1 1 1 1 1 1 7 8 25 0 
0 0 0 19 4 5 1 1 1 1 1 1 1 1 1 1 1 1 1 1 1 1 1 1 1 1 1 1 1 1 1 31 23 24 25 19 12 30 6 1 1 1 1 1 1 1 7 8 25 0 
0 0 0 19 4 5 1 1 1 1 1 1 1 1 1 1 1 1 1 1 1 1 1 1 1 1 1 1 1 1 10 10 11 8 25 16 26 12 30 1 1 1 1 1 1 1 7 8 25 0 
0 0 0 19 4 5 1 1 1 1 1 1 1 1 1 1 1 1 1 1 1 1 1 1 1 39 40 41 1 29 13 13 13 15 25 0 16 26 12 30 1 39 40 41 1 1 11 8 25 0 
0 2 3 28 4 5 1 1 1 1 1 1 39 40 41 1 1 1 1 1 6 39 40 40 40 38 43 44 7 8 34 34 33 17 18 0 0 19 34 4 5 42 43 44 1 29 13 15 25 0 
0 19 20 21 32 1 1 1 1 1 1 1 42 43 44 1 1 1 1 1 39 38 43 43 43 43 35 47 1 31 23 24 27 3 14 2 3 28 34 4 5 42 35 47 7 8 33 17 18 0 
0 19 4 5 1 1 1 39 40 41 1 1 42 43 37 40 40 40 40 41 42 43 35 46 46 46 47 1 1 1 1 31 23 24 27 28 20 21 22 32 1 45 47 1 29 15 25 0 0 0 
0 19 4 5 1 1 1 42 43 37 40 40 38 43 43 43 43 43 43 37 38 43 44 1 1 1 1 1 1 1 1 1 1 31 22 22 32 1 1 1 1 10 10 11 8 33 18 0 0 0 
0 19 4 5 1 1 1 45 36 43 43 43 35 46 46 46 46 46 46 36 43 35 47 1 1 1 1 1 1 1 1 1 1 1 1 39 40 40 41 1 29 13 13 13 15 25 0 0 0 0 
0 19 4 5 1 1 1 6 45 46 46 46 47 6 1 1 1 1 1 42 43 44 1 1 1 1 1 6 1 1 1 1 1 1 1 42 35 46 47 7 8 34 34 34 33 18 0 0 0 0 
0 19 4 9 10 10 10 10 10 10 10 10 1 1 1 1 1 1 1 42 43 44 1 1 1 1 1 1 39 40 41 1 1 1 39 38 44 1 10 11 8 34 34 34 25 0 0 0 0 0 
0 19 12 13 13 13 13 13 13 13 13 13 30 1 1 1 1 1 1 42 43 37 41 39 40 41 1 1 42 43 37 40 40 40 38 35 47 29 13 13 15 34 34 33 18 0 0 0 0 0 
0 16 17 17 17 17 17 17 17 17 17 26 4 5 1 1 1 1 1 42 43 43 37 38 43 37 40 40 38 35 36 43 43 43 35 47 7 8 34 34 34 34 34 25 0 0 0 0 0 0 
0 0 0 2 3 3 3 3 14 0 0 19 4 5 1 1 1 1 1 42 43 35 46 46 46 46 46 46 46 47 45 46 46 46 47 1 1 31 22 23 24 34 34 27 14 0 0 0 0 0 
0 0 0 19 20 21 23 24 27 3 3 28 4 5 39 40 41 6 39 38 35 47 1 10 10 10 1 1 1 1 1 1 1 1 1 1 1 1 1 1 31 22 23 24 27 3 14 0 0 0 
0 0 0 19 4 5 1 31 22 22 22 22 32 6 42 43 37 40 38 43 44 1 29 13 13 13 30 1 1 1 1 1 1 1 1 1 1 1 1 1 1 1 1 31 23 24 27 14 0 0 
0 0 0 19 4 9 10 10 10 10 1 1 1 6 45 36 43 43 43 35 47 29 15 34 34 34 4 5 1 1 1 1 1 1 1 1 1 1 1 1 1 1 1 1 7 8 34 27 3 14 
0 0 0 19 12 13 13 13 13 13 30 10 10 10 6 45 46 46 46 47 29 15 33 26 34 34 4 5 1 1 1 1 1 1 1 1 1 1 1 1 1 1 1 1 1 31 22 23 24 25 
0 0 0 16 17 17 17 17 17 26 12 13 13 13 30 10 10 10 1 7 8 33 18 19 20 21 32 1 1 1 1 1 1 1 1 1 1 1 1 1 1 1 1 1 1 1 6 7 8 25 
0 0 0 0 0 0 0 0 0 16 17 17 17 26 12 13 13 13 30 11 8 25 0 19 4 5 1 1 1 1 1 1 1 1 1 1 1 1 1 1 1 1 1 1 6 6 10 11 8 25 
0 0 0 0 0 0 0 0 0 0 0 0 0 16 17 17 17 26 12 13 15 25 0 19 4 9 10 10 10 1 1 1 1 1 1 1 1 1 1 1 1 1 1 1 1 29 13 13 15 25 
0 0 0 0 0 0 0 0 0 0 0 0 0 0 0 0 0 16 17 17 17 18 0 19 12 13 13 13 13 30 1 1 1 1 1 1 1 1 1 1 1 1 1 1 7 8 34 33 17 18 
0 0 0 0 0 0 0 0 0 0 0 0 2 3 3 3 3 14 0 0 0 0 0 16 17 17 17 17 26 4 5 1 1 1 1 1 1 1 1 1 1 1 1 1 7 8 33 18 0 0 
0 0 0 0 0 0 0 0 0 0 0 0 19 20 21 23 24 25 0 0 0 0 0 0 0 0 0 0 19 4 5 1 1 1 1 1 1 1 1 1 1 1 1 1 7 8 25 0 0 0 
0 0 0 0 0 0 0 0 0 0 2 3 28 4 5 7 8 25 0 0 0 2 3 3 3 3 3 3 28 4 5 1 1 1 1 1 1 1 1 1 1 1 1 1 11 8 25 0 0 0 
0 0 0 0 0 0 0 0 2 3 28 20 21 32 1 7 8 25 0 0 0 19 20 21 22 22 22 22 22 32 1 1 1 1 1 1 1 1 1 1 1 1 1 29 13 15 25 0 0 0 
0 0 0 0 0 0 0 0 19 34 34 4 5 1 1 7 8 25 0 0 0 19 4 5 1 1 1 1 1 1 1 1 1 1 1 1 1 1 1 1 1 10 11 8 33 17 18 0 0 0 
0 0 0 0 0 0 0 2 28 34 34 4 5 1 1 7 8 27 3 14 0 19 4 5 1 1 1 1 1 1 1 1 1 1 1 1 1 1 1 1 29 13 13 15 25 0 0 0 0 0 
0 0 0 0 0 0 2 28 34 34 34 4 5 1 1 1 31 23 24 25 0 19 4 5 1 1 1 1 1 1 1 1 1 10 10 1 1 1 1 7 8 33 17 17 18 0 0 0 0 0 
0 0 0 0 0 2 28 34 34 20 21 32 1 1 1 1 1 7 8 27 3 28 4 5 1 1 1 1 1 1 1 10 29 13 13 30 10 10 10 11 8 25 0 0 0 0 0 0 0 0 
0 0 0 0 0 19 20 21 22 32 1 1 1 1 1 1 1 1 31 22 22 22 32 1 1 1 1 1 1 6 29 13 15 34 34 12 13 13 13 13 15 25 0 0 0 0 0 0 0 0 
0 0 0 0 0 19 4 5 1 1 1 1 1 1 1 1 1 1 1 1 1 1 1 1 1 1 1 1 1 29 15 34 34 34 34 34 33 17 17 17 17 18 0 0 0 0 0 0 0 0 
0 0 0 0 0 19 4 5 1 1 1 1 10 10 10 10 10 10 1 1 1 1 1 1 1 1 1 1 7 8 34 34 34 34 33 17 18 0 0 0 0 0 0 0 0 0 0 0 0 0 
0 0 0 0 0 19 4 5 1 1 1 29 13 13 13 13 13 13 30 10 10 10 1 1 1 1 1 1 7 8 34 34 33 17 18 0 0 0 0 0 0 0 0 0 0 0 0 0 0 0 
0 0 0 0 0 19 4 9 10 10 11 8 33 17 17 17 17 26 12 13 13 13 30 10 10 10 10 10 11 8 34 33 18 0 0 0 0 0 0 0 0 0 0 0 0 0 0 0 0 0 
0 0 0 0 0 19 12 13 13 13 13 15 25 0 0 0 0 16 17 17 17 26 12 13 13 13 13 13 13 15 33 18 0 0 0 0 0 0 0 0 0 0 0 0 0 0 0 0 0 0 
0 0 0 0 0 16 17 17 17 17 17 17 18 0 0 0 0 0 0 0 0 16 17 17 17 17 17 17 17 17 18 0 0 0 0 0 0 0 0 0 0 0 0 0 0 0 0 0 0 0 
