0 0 0 0 0 0 0 0 0 0 0 0 0 0 0 0 0 0 0 0 0 0 0 0 0 0 0 0 0 0 0 0 0 0 0 0 0 0 0 0 0 0 0 0 0 0 0 0 0 0 
0 0 0 0 0 0 0 0 0 0 0 0 0 0 0 0 0 0 0 0 0 0 0 0 0 0 0 0 0 0 0 0 0 0 0 0 0 0 0 0 0 0 0 0 0 0 0 0 0 0 
0 0 0 0 0 0 0 0 0 0 0 0 0 0 0 0 0 0 0 0 0 0 0 0 0 0 0 0 0 0 0 0 0 0 0 0 0 0 0 0 0 0 0 0 0 0 0 0 0 0 
0 0 0 0 0 0 0 0 0 0 0 0 0 0 0 0 0 0 0 0 0 0 0 0 0 0 0 0 0 0 0 0 0 0 0 0 0 0 0 0 0 0 0 0 0 0 0 0 0 0 
0 0 0 0 0 0 0 0 0 0 0 0 0 0 0 0 0 0 0 0 0 0 0 0 0 0 0 0 0 0 0 0 0 0 0 0 0 0 0 0 0 0 0 0 0 0 0 0 0 0 
0 0 0 0 0 0 0 0 0 0 0 0 0 0 0 0 0 0 0 0 0 0 0 0 0 0 0 0 0 0 0 0 0 0 0 0 0 0 0 0 0 0 0 0 0 0 0 0 0 0 
0 0 0 0 0 0 0 0 0 0 0 0 0 0 0 0 0 0 0 0 0 0 0 0 0 0 0 0 0 0 0 0 0 0 0 0 0 0 0 0 0 0 0 0 0 0 0 0 0 0 
0 0 0 0 0 0 0 0 0 0 0 0 0 0 0 0 0 0 0 0 0 0 0 0 0 0 2 3 3 3 3 14 0 0 0 0 0 0 0 0 0 0 0 0 0 0 0 0 0 0 
0 0 0 0 0 0 0 0 0 0 0 2 3 3 3 3 3 3 14 0 0 0 0 0 0 2 28 20 21 23 24 25 0 0 0 0 0 0 0 0 2 3 3 3 3 3 14 0 0 0 
0 0 0 0 0 0 0 0 0 0 0 19 20 21 22 22 23 24 27 14 0 0 0 0 2 28 20 32 6 7 8 25 0 0 0 0 0 2 3 3 28 20 21 22 23 24 25 0 0 0 
0 0 0 0 0 0 0 0 0 0 0 19 4 5 1 1 1 31 24 27 14 0 2 3 28 20 32 1 1 7 8 25 0 0 0 0 0 19 20 21 22 31 1 1 7 8 27 3 14 0 
0 0 0 0 0 0 0 0 2 3 3 28 4 5 1 1 1 1 31 24 27 3 28 20 22 32 1 1 1 7 8 27 14 0 0 2 3 28 4 5 1 1 1 1 1 31 23 24 25 0 
0 0 2 3 3 3 3 3 28 20 21 22 32 1 1 1 1 1 1 31 22 22 22 32 1 1 1 1 1 1 31 24 27 14 0 19 20 21 31 1 1 1 1 1 1 1 7 8 25 0 
0 0 19 20 21 22 22 22 22 32 1 1 1 1 1 1 1 1 1 1 1 1 1 1 1 1 1 1 1 1 6 31 24 27 14 19 4 5 1 1 1 1 1 1 1 1 1 31 24 25 
0 0 19 4 5 1 1 1 1 1 1 1 1 1 1 1 1 1 1 1 1 1 1 1 1 1 1 1 1 1 1 1 31 24 25 19 12 30 6 1 1 1 1 1 1 1 1 7 8 25 
0 0 19 4 5 1 1 1 1 1 1 1 1 1 1 1 1 1 1 1 1 1 1 1 1 1 1 1 1 1 1 1 7 8 25 16 26 12 30 1 1 1 1 1 1 1 1 7 8 25 
0 0 19 4 5 1 1 1 1 1 1 1 1 1 1 1 1 1 1 1 1 1 1 1 1 1 1 1 1 1 1 6 29 15 25 0 0 26 12 30 1 1 1 1 1 1 10 11 8 25 
0 2 28 4 5 1 1 1 1 1 1 1 1 1 1 1 1 1 1 1 1 1 1 1 1 1 1 1 1 1 1 29 15 33 18 0 0 19 34 4 5 1 1 1 1 29 13 13 15 25 
0 19 20 31 1 1 1 1 1 1 1 1 1 1 1 1 1 1 1 1 1 1 1 1 1 1 1 1 1 1 1 31 24 27 14 0 2 28 20 32 1 1 1 1 7 8 33 17 17 18 
0 19 4 5 1 1 1 1 1 1 1 1 1 1 1 1 1 1 1 1 1 1 1 1 1 1 1 1 1 1 1 1 31 24 27 3 28 20 5 1 1 1 1 1 29 8 25 0 0 0 
0 19 4 5 1 10 10 10 10 6 1 1 1 1 1 1 1 1 1 1 1 1 1 1 1 1 1 1 1 1 1 1 1 1 22 22 22 32 1 1 1 10 10 11 8 33 18 0 0 0 
0 19 4 9 29 13 13 13 13 30 1 1 1 1 1 1 1 1 1 1 1 1 1 1 1 1 1 1 1 1 1 1 1 1 1 1 1 1 1 1 29 13 13 13 15 25 0 0 0 0 
0 19 12 13 15 33 17 17 26 12 30 1 1 1 1 1 1 1 1 1 1 1 1 1 1 1 1 1 1 1 1 1 1 1 1 1 1 1 1 7 8 34 34 34 33 18 0 0 0 0 
0 16 17 17 17 18 0 0 16 26 4 5 1 1 1 1 1 1 1 1 1 1 1 1 1 1 1 1 1 1 1 1 1 1 1 1 1 1 10 11 8 34 34 34 25 0 0 0 0 0 
0 0 0 0 0 0 0 0 0 19 4 5 1 1 1 1 1 1 1 1 1 1 1 1 1 1 1 1 1 1 1 1 1 1 1 1 1 29 13 13 15 34 34 33 18 0 0 0 0 0 
0 0 0 0 0 0 0 0 2 28 4 5 1 1 1 1 1 1 1 1 1 1 1 1 1 1 1 1 1 1 1 1 1 1 1 1 7 8 34 34 34 34 34 25 0 0 0 0 0 0 
0 0 0 0 0 0 0 2 28 20 31 1 1 1 1 1 1 1 1 1 1 1 1 1 1 1 1 1 1 1 1 1 1 1 1 1 1 31 22 23 24 34 34 27 14 0 0 0 0 0 
0 0 0 0 0 0 0 19 20 31 1 1 1 1 1 1 1 1 1 1 1 1 1 10 10 10 1 1 1 1 1 1 1 1 1 1 1 1 1 1 31 22 23 24 27 3 14 0 0 0 
0 0 0 0 0 0 0 19 4 5 1 1 1 1 1 1 1 1 1 1 1 1 29 13 13 13 30 1 1 1 1 1 1 1 1 1 1 1 1 1 1 1 1 31 23 24 27 14 0 0 
0 0 0 0 0 0 0 19 4 9 1 1 1 1 1 1 1 1 1 1 1 29 15 34 34 34 4 5 1 1 1 1 1 1 1 1 1 1 1 1 1 1 1 1 1 31 24 27 14 0 
0 0 0 0 0 0 0 19 12 13 30 10 10 10 1 1 1 1 1 1 29 15 33 26 34 34 4 5 1 1 1 1 1 1 1 1 1 1 1 1 1 1 1 1 1 1 31 24 27 14 
0 0 0 0 0 0 0 16 17 26 12 13 13 13 30 10 10 10 1 7 8 33 18 19 20 21 32 1 1 1 1 1 1 1 1 1 1 1 1 1 1 1 1 1 1 1 1 31 24 25 
0 0 0 0 0 0 0 0 0 16 17 17 17 26 12 13 13 13 30 11 8 25 0 19 4 5 1 1 1 1 1 1 1 1 1 1 1 1 1 1 1 1 1 1 6 6 10 11 8 25 
0 0 0 0 0 0 0 0 0 0 0 0 0 16 17 17 17 26 12 13 15 25 0 19 4 9 10 10 10 1 1 1 1 1 1 1 1 1 1 1 1 1 1 1 1 29 13 13 15 25 
0 0 0 0 0 0 0 0 0 0 0 0 0 0 0 0 0 16 17 17 17 18 0 19 12 13 13 13 13 30 1 1 1 1 1 1 1 1 1 1 1 1 1 1 7 8 34 33 17 18 
0 0 0 0 0 0 0 0 0 0 0 0 0 2 3 3 3 3 14 0 0 0 0 16 17 17 17 17 26 4 5 1 1 1 1 1 1 1 1 1 1 1 1 1 7 8 33 18 0 0 
0 0 0 0 0 0 0 0 0 0 0 0 0 19 20 21 23 24 25 0 0 0 0 0 0 0 0 0 19 4 5 1 1 1 1 1 1 1 1 1 1 1 1 1 7 8 25 0 0 0 
0 0 0 0 0 0 0 0 0 0 0 0 2 28 4 5 7 8 25 0 0 2 3 3 3 3 3 3 28 4 5 1 1 1 1 1 1 1 1 1 1 1 1 1 11 8 25 0 0 0 
0 0 0 0 0 0 0 0 0 0 0 0 19 20 31 1 7 8 25 0 0 19 20 21 22 22 22 22 22 31 1 1 1 1 1 1 1 1 1 1 1 1 1 29 13 15 25 0 0 0 
0 0 0 0 0 0 0 0 0 0 0 0 19 4 5 1 7 8 25 0 0 19 4 5 1 1 1 1 1 1 1 1 1 1 1 1 1 1 1 1 1 10 11 8 33 17 18 0 0 0 
0 0 0 0 0 0 0 0 0 0 0 0 19 4 5 1 7 8 27 14 0 19 4 5 1 1 1 1 1 1 1 1 1 1 1 1 1 1 1 1 29 13 13 15 25 0 0 0 0 0 
0 0 0 0 0 0 0 0 0 0 0 2 28 4 5 1 1 31 8 25 0 19 4 5 1 1 1 1 1 1 1 1 1 10 10 1 1 1 1 7 8 33 17 17 18 0 0 0 0 0 
0 0 0 0 0 0 0 0 0 0 0 19 4 31 1 1 1 7 8 27 3 28 4 5 1 1 1 1 1 1 1 10 29 13 13 30 10 10 10 11 8 25 0 0 0 0 0 0 0 0 
0 0 0 0 0 0 0 0 0 0 0 19 4 5 1 1 1 1 31 22 22 22 31 1 1 1 1 1 1 6 29 13 15 34 34 12 13 13 13 13 15 25 0 0 0 0 0 0 0 0 
0 0 0 0 0 0 0 0 0 0 0 19 4 5 1 1 1 1 1 1 1 1 1 1 1 1 1 1 1 29 15 34 34 34 34 34 33 17 17 17 17 18 0 0 0 0 0 0 0 0 
0 0 0 0 0 0 0 0 0 0 0 19 4 9 10 10 10 10 1 1 1 1 1 1 1 1 1 1 7 8 34 34 34 34 33 17 18 0 0 0 0 0 0 0 0 0 0 0 0 0 
0 0 0 0 0 0 0 0 0 0 0 19 12 13 13 13 13 13 30 10 10 10 1 1 1 1 1 1 7 8 34 34 33 17 18 0 0 0 0 0 0 0 0 0 0 0 0 0 0 0 
0 0 0 0 0 0 0 0 0 0 0 16 17 17 17 17 17 26 13 13 13 13 30 10 10 10 10 10 11 8 34 33 18 0 0 0 0 0 0 0 0 0 0 0 0 0 0 0 0 0 
0 0 0 0 0 0 0 0 0 0 0 0 0 0 0 0 0 16 17 17 17 26 13 13 13 13 13 13 13 15 33 18 0 0 0 0 0 0 0 0 0 0 0 0 0 0 0 0 0 0 
0 0 0 0 0 0 0 0 0 0 0 0 0 0 0 0 0 0 0 0 0 16 17 17 17 17 17 17 17 17 18 0 0 0 0 0 0 0 0 0 0 0 0 0 0 0 0 0 0 0 
